#,#,#,#,#,#,#,#
#,S, ,#, , , ,#
#, ,#,#, ,#, ,#
#, , , , ,#, ,#
#,#,#,#, ,#, ,#
#, , , , , , ,#
#, ,#, ,#,#,#,#
#, , , , , ,G,#
#,#,#,#,#,#,#,#